1111111111111
10000C1000111
1010110000001
1000000011001
1P011111E0001
1111111111111